"team_id","intermediate_fee","advanced_fee"
19,"20000","30000"
21,"20000","30000"
22,"20000","30000"
23,"20000","30000"
24,"20000","30000"
25,"20000","30000"
26,"20000","30000"
27,"20000","30000"
28,"20000","30000"
29,"20000","30000"
30,"20000","30000"
31,"20000","30000"
32,"20000","30000"
